200 200 2
14 5 2
00 00 00 00 00 00 00 00 00 00 00 00 00 00 00 00 00 00 00 00
00 00 00 00 00 00 00 00 00 00 00 00 00 00 00 00 00 00 00 00
00 00 00 00 00 00 00 00 00 00 00 00 00 00 00 00 00 00 00 00
00 00 24 24 24 24 24 24 24 24 24 24 24 24 24 24 24 24 00 00
00 00 24 29 27 27 27 27 27 27 27 27 27 27 27 27 30 24 00 00
00 00 24 25 -1 -1 -1 -1 -1 -1 -1 -1 -1 -1 -1 -1 23 24 00 00
00 00 24 25 -1 -1 -1 -1 -1 -1 -1 -1 -1 -1 -1 -1 23 24 00 00
00 00 24 25 -1 -1 -1 -1 -1 -1 -1 -1 -1 -1 -1 -1 23 24 00 00
00 00 24 25 -1 -1 -1 -1 -1 -1 -1 -1 -1 -1 -1 -1 23 24 00 00
00 00 24 25 -1 -1 -1 -1 -1 -1 -1 -1 -1 -1 -1 -1 23 24 00 00
00 00 24 31 07 07 07 07 07 07 07 07 07 07 38 07 32 24 00 00
00 00 24 24 24 24 24 24 24 24 24 24 24 24 24 24 24 24 00 00
00 00 00 00 00 00 00 00 00 00 00 00 00 00 00 00 00 00 00 00
00 00 00 00 00 00 00 00 00 00 00 00 00 00 00 00 00 00 00 00
00 00 00 00 00 00 00 00 00 00 00 00 00 00 00 00 00 00 00 00
0
0