200 180 2
00 00 00 00 00 00 00 00 00 00 00 00 00 00 00 00 00 00 00 00 
00 00 00 00 00 00 00 00 00 00 00 00 00 00 00 00 00 00 00 00
00 00 00 00 00 00 24 24 24 24 24 24 24 24 24 24 24 24 00 00 
00 00 00 00 00 00 24 29 27 27 27 27 27 27 36 27 30 24 00 00 
00 00 00 00 00 00 24 25 -1 -1 -1 -1 -1 -1 40 -1 23 24 00 00 
00 00 00 00 00 00 24 25 -1 -1 -1 -1 -1 -1 -1 -1 23 24 00 00 
00 00 24 24 24 24 24 25 -1 -1 -1 -1 -1 -1 -1 -1 23 24 00 00 
00 00 24 29 27 27 27 28 -1 -1 -1 -1 04 07 07 07 32 24 00 00 
00 00 24 25 -1 -1 -1 -1 -1 -1 -1 -1 23 24 24 24 24 24 00 00 
00 00 24 25 -1 -1 -1 -1 -1 -1 -1 -1 23 24 00 00 00 00 00 00 
00 00 24 25 -1 -1 -1 -1 -1 -1 -1 -1 23 24 00 00 00 00 00 00 
00 00 24 31 07 07 07 07 07 07 07 07 32 24 00 00 00 00 00 00 
00 00 24 24 24 24 24 24 24 24 24 24 24 24 00 00 00 00 00 00
00 00 00 00 00 00 00 00 00 00 00 00 00 00 00 00 00 00 00 00 
00 00 00 00 00 00 00 00 00 00 00 00 00 00 00 00 00 00 00 00  
0