220 100 2
00 00 00 00 24 29 27 27 27 27 27 27 27 27 30 24 00 00 00 00 
00 00 00 00 24 25 -1 -1 -1 -1 -1 -1 -1 -1 23 24 00 00 00 00 
00 00 00 00 24 25 -1 -1 -1 -1 -1 -1 -1 42 23 24 00 00 00 00 
00 00 00 00 24 25 -1 -1 04 07 07 07 07 38 32 24 00 00 00 00 
00 00 00 00 24 25 -1 -1 23 24 24 29 27 27 30 24 00 00 00 00 
00 00 00 00 24 25 -1 -1 13 27 27 28 44 44 23 24 00 00 00 00 
00 00 00 00 24 25 -1 -1 -1 -1 -1 -1 -1 -1 23 24 00 00 00 00 
00 00 00 00 24 25 -1 -1 -1 -1 -1 -1 -1 -1 23 24 00 00 00 00 
00 00 00 00 24 25 46 46 04 07 07 05 -1 -1 23 24 00 00 00 00 
00 00 00 00 24 31 21 21 32 24 24 25 -1 -1 23 24 00 00 00 00 
00 00 00 00 24 29 27 27 27 27 27 28 -1 -1 23 24 00 00 00 00 
00 00 00 00 24 25 -1 -1 -1 -1 -1 -1 -1 -1 23 24 00 00 00 00 
00 00 00 00 24 25 -1 -1 -1 -1 -1 -1 -1 -1 23 24 00 00 00 00 
00 00 00 00 24 31 07 07 07 07 07 05 46 46 23 24 00 00 00 00 
00 00 00 00 24 24 24 24 24 24 24 31 21 21 32 24 00 00 00 00 
 
0