120 120 2
00 00 00 00 00 00 00 00 00 00 00 00 00 00 00 00 00 00 00 00 
00 00 24 24 24 24 24 24 24 24 24 24 24 24 24 24 24 24 24 00 
00 24 24 29 27 27 27 27 27 27 27 30 24 24 29 27 27 30 24 00 
00 24 29 28 44 44 44 44 44 44 44 13 30 24 25 -1 41 37 24 24 
00 24 25 -1 -1 -1 -1 -1 -1 -1 -1 -1 23 24 25 -1 -1 13 30 24 
00 24 25 -1 -1 -1 -1 -1 -1 -1 -1 -1 13 30 25 -1 -1 45 23 24 
00 24 25 -1 -1 -1 04 07 05 -1 -1 -1 45 23 25 -1 -1 45 23 24 
00 24 25 -1 -1 -1 23 29 28 -1 -1 -1 45 23 25 -1 -1 45 23 24 
00 24 25 -1 -1 -1 23 25 47 -1 -1 -1 08 32 25 -1 -1 45 23 24 
00 24 25 -1 -1 -1 23 25 47 -1 -1 -1 13 27 28 -1 -1 08 32 24 
00 24 25 -1 -1 -1 23 31 22 -1 -1 -1 -1 -1 -1 -1 -1 23 24 24 
00 24 25 -1 -1 -1 23 24 25 -1 -1 -1 -1 -1 -1 -1 -1 23 24 00 
00 24 31 07 07 07 32 24 31 07 07 07 07 07 07 07 07 32 24 00 
00 24 24 24 24 24 24 24 24 24 24 24 24 24 24 24 24 24 24 00 
00 00 00 00 00 00 00 00 00 00 00 00 00 00 00 00 00 00 00 00 
1 4 9