112 180 2
17 5 2
00 00 24 24 24 29 27 27 27 30 29 27 27 27 30 24 24 24 24 00 
00 24 24 29 27 28 40 40 40 13 28 40 40 40 13 27 30 24 24 00 
00 24 29 28 40 40 -1 -1 -1 -1 -1 -1 -1 -1 40 40 13 30 24 00 
00 24 25 -1 -1 -1 -1 -1 -1 -1 -1 -1 -1 -1 -1 -1 -1 23 24 00 
00 24 25 -1 -1 -1 -1 -1 -1 -1 -1 -1 -1 -1 -1 -1 -1 23 24 00 
00 24 25 -1 -1 -1 04 07 05 -1 -1 04 07 05 -1 -1 -1 23 24 00 
00 24 25 -1 -1 -1 23 24 25 -1 -1 23 24 25 -1 -1 -1 23 24 00 
00 24 25 -1 -1 -1 13 27 28 -1 -1 13 27 28 -1 -1 -1 13 30 00 
00 24 25 -1 -1 -1 -1 -1 -1 -1 -1 -1 -1 -1 -1 -1 -1 -1 23 00 
00 24 25 -1 -1 -1 -1 -1 -1 -1 -1 -1 -1 -1 -1 -1 -1 -1 23 00 
00 24 31 05 -1 -1 -1 -1 -1 -1 -1 -1 -1 -1 -1 -1 04 38 32 00 
00 00 24 31 05 -1 -1 04 05 -1 -1 04 05 -1 -1 04 32 24 24 00 
00 00 24 24 25 42 42 23 25 42 42 23 25 42 42 23 24 24 00 00 
00 00 00 24 31 21 21 32 31 21 21 32 31 21 21 32 24 00 00 00 
00 00 00 24 24 24 24 24 24 24 24 24 24 24 24 24 24 00 00 00 
0
4
0 3 8 1 0 2
0 16 8 0 0 2
1 8 6 0 0 2
1 11 6 0 0 2