200 100 2
00 00 00 00 14 14 14 14 14 14 14 14 14 14 14 14 00 00 -1 -1 
00 00 00 14 14 06 07 07 07 07 07 07 07 07 08 14 14 00 00 00 
00 00 00 14 06 12 -1 -1 -1 -1 -1 -1 -1 -1 13 08 14 00 00 00 
00 00 00 14 05 -1 -1 -1 -1 -1 -1 -1 -1 -1 -1 09 14 00 00 00 
00 00 00 14 05 -1 -1 -1 -1 -1 -1 -1 -1 -1 -1 09 14 00 00 00 
00 00 00 14 05 -1 -1 -1 -1 -1 -1 -1 -1 -1 -1 09 14 00 00 00 
00 00 00 14 04 11 -1 -1 -1 -1 -1 -1 -1 -1 11 10 14 00 00 00 
00 00 00 14 14 05 -1 -1 -1 01 03 -1 -1 -1 09 14 14 00 00 00 
00 00 00 00 14 05 -1 -1 -1 09 05 -1 -1 -1 09 14 00 00 00 00 
00 00 14 14 14 05 -1 -1 -1 09 05 -1 -1 -1 09 14 14 14 00 00 
00 00 14 06 07 12 -1 -1 -1 09 05 -1 -1 -1 13 07 08 14 00 00 
00 00 14 05 -1 -1 -1 -1 -1 09 05 -1 -1 -1 -1 -1 09 14 00 00 
00 00 14 05 -1 -1 -1 -1 -1 09 05 -1 -1 -1 -1 -1 09 14 00 00 
00 00 14 04 02 02 02 02 02 10 04 02 02 02 02 15 10 14 00 00 
00 00 14 14 14 14 14 14 14 14 14 14 14 14 14 14 14 14 00 00 
0