80 110 2
15 5 0
24 24 24 24 24 24 24 24 24 24 24 24 24 00 00 00 00 00 00 00 
24 29 27 27 27 30 24 29 27 27 27 30 24 00 00 00 00 00 00 00 
24 25 40 40 40 23 24 25 -1 -1 -1 23 24 00 00 00 00 00 00 00 
24 25 -1 -1 -1 13 27 28 -1 -1 -1 23 24 00 00 00 00 00 00 00 
24 25 -1 -1 -1 40 40 40 -1 -1 -1 23 24 00 00 00 00 00 00 00 
24 25 -1 -1 -1 -1 -1 -1 -1 -1 -1 23 24 24 24 00 00 00 00 00 
24 25 -1 -1 -1 42 42 42 -1 -1 -1 13 27 30 24 00 00 00 00 00 
24 25 -1 -1 -1 04 07 05 -1 -1 -1 -1 41 23 24 24 24 24 24 24 
24 25 -1 -1 -1 23 24 25 -1 -1 -1 -1 41 23 29 36 27 27 30 24 
24 25 -1 -1 -1 23 24 25 -1 -1 -1 08 21 32 25 -1 -1 41 23 24 
24 25 -1 -1 -1 23 24 25 -1 -1 -1 13 27 27 28 -1 -1 41 23 24 
24 25 -1 -1 -1 23 24 25 -1 -1 -1 -1 -1 -1 -1 -1 -1 41 23 24 
24 31 07 07 07 32 24 25 -1 -1 -1 -1 -1 -1 -1 -1 -1 41 23 24 
24 24 24 24 24 24 24 31 07 07 07 07 07 07 07 07 07 07 32 24 
00 00 00 00 00 00 24 24 24 24 24 24 24 24 24 24 24 24 24 24 
2
3 6 0
16 3 0
3
2 8 2 3 1 0 5
2 10 8 1 1 0 4
0 8 5 1 0 2