48 420 2
14 11 3
29 27 27 27 27 27 27 27 30 24 00 00 24 24 24 24 24 24 24 24 
25 -1 -1 -1 -1 -1 -1 -1 23 24 00 00 24 29 27 27 27 27 27 30 
25 -1 -1 -1 -1 -1 -1 -1 23 24 00 00 24 25 -1 -1 -1 -1 -1 23 
31 07 07 07 07 05 -1 -1 23 24 00 00 24 39 -1 -1 -1 -1 -1 23 
24 24 24 24 24 25 -1 -1 23 24 00 00 24 31 07 07 05 -1 -1 23 
24 24 24 24 24 25 -1 -1 23 24 24 24 24 24 24 24 25 -1 -1 23 
29 27 27 27 27 15 -1 -1 13 27 27 27 27 27 27 27 28 -1 -1 23 
25 -1 -1 -1 -1 -1 -1 -1 40 -1 -1 -1 -1 -1 -1 -1 -1 -1 -1 23 
25 -1 -1 -1 -1 -1 -1 -1 -1 -1 16 -1 -1 -1 16 -1 -1 -1 -1 23 
25 -1 -1 -1 42 42 -1 -1 42 -1 -1 -1 -1 -1 -1 -1 -1 -1 -1 23 
25 -1 -1 41 04 05 43 -1 04 07 07 07 07 07 07 07 07 07 07 32 
25 -1 -1 41 13 15 43 -1 23 24 24 24 24 24 24 24 24 24 24 24 
25 -1 -1 -1 40 40 -1 -1 23 24 00 00 00 00 00 00 00 00 00 00 
25 -1 -1 -1 -1 -1 -1 -1 23 24 00 00 00 00 00 00 00 00 00 00 
31 07 07 07 07 07 07 07 32 24 00 00 00 00 00 00 00 00 00 00 
1
2 6 0
2
1 12 7 0 0 2
1 16 5 1 0 2