48 420 2
17 12 1
29 27 27 27 27 30 24 29 27 27 27 27 27 27 27 27 27 27 30 24 
25 -1 -1 -1 -1 23 24 25 -1 -1 -1 -1 -1 -1 -1 -1 -1 -1 23 24 
25 -1 -1 -1 -1 23 24 25 -1 -1 -1 -1 -1 -1 -1 -1 -1 -1 37 24 
31 07 07 05 -1 23 24 25 -1 -1 04 07 07 07 07 07 07 07 32 24 
29 27 27 15 -1 23 24 25 -1 -1 13 27 27 27 30 24 24 24 24 24 
25 -1 -1 -1 -1 23 24 25 -1 -1 40 40 40 40 23 24 00 00 00 00 
25 -1 -1 -1 -1 23 24 25 -1 -1 -1 -1 -1 -1 23 24 00 00 00 00 
25 -1 -1 08 21 32 24 31 07 07 05 -1 -1 08 32 24 00 00 00 00 
25 -1 -1 23 29 27 27 27 30 24 25 -1 -1 23 24 24 00 00 00 00 
25 -1 -1 23 25 -1 -1 -1 23 24 25 -1 -1 23 24 00 00 00 00 00 
25 -1 -1 23 25 -1 -1 -1 23 24 25 -1 -1 23 24 24 00 00 00 00 
25 -1 -1 13 28 -1 -1 -1 13 27 28 -1 -1 13 30 24 00 00 00 00 
25 -1 -1 -1 -1 -1 -1 -1 -1 -1 -1 -1 -1 41 23 24 00 00 00 00 
25 -1 -1 -1 -1 -1 -1 -1 -1 -1 -1 -1 -1 41 23 24 00 00 00 00 
31 07 07 07 07 07 07 07 07 07 07 07 07 07 32 24 00 00 00 00 
1
6 4 0
4
0 1 8 1 0 3
0 5 3 1 0 2
2 11 7 3 0 0 4
2 12 3 1 1 0 4