48 100 2
16 12 1
00 00 00 00 00 00 00 00 24 24 29 27 27 27 27 27 27 30 24 00 
00 00 00 00 00 00 00 00 24 29 28 40 40 40 40 40 40 23 24 00 
00 00 00 00 00 00 00 00 24 25 43 -1 -1 -1 -1 -1 -1 37 24 00 
00 00 00 00 00 00 00 00 24 25 43 -1 -1 -1 -1 -1 -1 23 24 00 
00 00 00 00 00 00 00 00 24 25 43 -1 -1 -1 42 42 42 23 24 00 
00 00 00 00 00 00 00 00 24 25 43 -1 -1 41 08 21 21 32 24 00 
24 24 24 24 24 24 24 24 24 25 43 -1 -1 41 23 24 24 24 24 00 
29 27 27 27 27 27 27 27 27 28 43 -1 -1 41 23 24 00 00 00 00 
25 40 40 40 40 40 40 40 40 40 -1 -1 -1 41 23 24 00 00 00 00 
25 -1 -1 -1 -1 -1 -1 -1 -1 -1 -1 -1 -1 41 23 24 00 00 00 00 
25 -1 -1 -1 -1 -1 -1 -1 -1 -1 -1 -1 -1 41 23 24 00 00 00 00 
25 -1 -1 -1 42 42 42 42 42 42 42 42 42 08 32 24 00 00 00 00 
25 -1 -1 -1 08 21 21 21 21 21 21 21 21 32 24 24 00 00 00 00 
25 -1 -1 -1 23 24 24 24 24 24 24 24 24 24 24 00 00 00 00 00 
31 07 07 07 32 24 00 00 00 00 00 00 00 00 00 00 00 00 00 00 
3
3 5 0
12 4 1
11 12 0
0