48 60 2
17 2 2
24 29 27 27 27 30 24 24 00 00 00 00 00 00 00 00 00 00 00 00 
29 28 40 40 40 13 30 24 00 00 00 00 00 00 00 00 00 00 00 00 
25 -1 -1 -1 -1 -1 23 24 00 00 00 00 00 00 00 00 00 00 00 00 
25 -1 -1 -1 -1 -1 23 24 24 24 24 24 24 24 24 24 00 00 00 00 
25 -1 -1 -1 -1 -1 23 29 27 27 27 27 27 27 30 24 24 24 00 00 
25 -1 -1 -1 -1 -1 23 25 40 40 40 40 40 40 13 27 30 24 24 24 
31 05 -1 -1 -1 04 32 25 -1 -1 -1 -1 -1 -1 40 40 13 27 30 24 
29 28 -1 -1 -1 23 24 25 -1 -1 -1 -1 -1 -1 -1 -1 40 40 13 30 
25 -1 -1 -1 -1 13 30 25 -1 -1 -1 42 42 42 -1 -1 -1 -1 40 23 
31 22 -1 -1 -1 -1 23 25 -1 -1 -1 04 07 05 42 42 -1 -1 -1 23 
24 25 -1 -1 -1 04 32 25 -1 -1 -1 13 30 31 07 05 -1 -1 -1 23 
29 28 -1 -1 -1 13 27 28 -1 -1 -1 -1 23 24 24 25 -1 -1 -1 23 
25 -1 -1 -1 -1 -1 -1 -1 -1 -1 -1 04 32 24 24 25 -1 -1 -1 23 
25 -1 -1 -1 -1 -1 -1 -1 -1 -1 -1 23 24 24 24 31 07 38 07 32 
31 07 07 07 07 07 07 07 07 07 07 32 24 00 24 24 24 24 24 24 
2
3 11 0
17 5 1
4
3 1 6 1 0 80
3 5 5 0 36 80
3 11 3 0 0 80
0 8 5 1 0 2