48 140 2
13 11 2
25 40 40 40 40 40 40 40 40 40 40 23 29 27 27 27 27 27 30 24 
25 -1 -1 -1 -1 -1 -1 -1 -1 -1 -1 23 25 -1 -1 -1 40 40 13 30 
25 -1 -1 -1 -1 -1 -1 -1 -1 -1 -1 23 25 -1 -1 -1 -1 -1 41 23 
25 -1 -1 -1 -1 -1 -1 -1 -1 -1 -1 23 25 -1 -1 -1 -1 -1 41 23 
25 -1 -1 -1 -1 -1 -1 -1 -1 -1 -1 23 31 38 05 43 -1 -1 41 23 
25 -1 -1 -1 -1 -1 -1 -1 -1 -1 -1 23 24 24 25 43 -1 -1 41 23 
25 -1 -1 -1 -1 -1 -1 -1 -1 -1 -1 23 24 24 25 43 -1 -1 41 23 
25 -1 -1 -1 -1 -1 -1 -1 -1 -1 -1 13 27 27 28 43 -1 -1 41 23 
25 -1 -1 -1 -1 -1 -1 -1 -1 -1 -1 40 40 40 40 -1 -1 -1 41 23 
25 -1 -1 -1 -1 -1 -1 -1 -1 -1 -1 -1 -1 -1 -1 -1 -1 -1 41 23 
25 -1 -1 -1 -1 -1 -1 -1 -1 -1 -1 -1 -1 -1 -1 -1 -1 -1 41 23 
25 -1 -1 -1 -1 -1 -1 -1 -1 -1 -1 42 42 42 42 42 42 42 08 32 
31 07 05 -1 -1 -1 -1 -1 -1 -1 -1 08 21 21 21 21 21 21 32 24 
24 24 25 -1 -1 -1 -1 -1 -1 -1 -1 23 24 24 24 24 24 24 24 24 
00 24 25 42 42 42 42 42 42 42 42 23 24 00 00 00 00 00 00 00 
2
6 12 0
17 6 1
0