48 100 2
18 12 0
25 -1 -1 -1 23 24 25 -1 -1 -1 23 24 25 -1 -1 -1 23 24 24 24 
25 -1 -1 -1 23 24 25 -1 -1 -1 23 24 25 -1 -1 -1 13 27 36 30 
25 -1 -1 -1 23 24 25 -1 -1 -1 23 24 25 -1 -1 -1 -1 -1 -1 23 
25 -1 -1 -1 23 24 25 -1 -1 -1 13 27 15 -1 -1 -1 -1 -1 -1 23 
25 -1 -1 -1 23 24 25 -1 -1 -1 -1 -1 -1 -1 -1 -1 -1 -1 -1 23 
25 -1 -1 -1 13 27 15 -1 -1 -1 -1 -1 -1 -1 -1 -1 -1 -1 -1 23 
25 -1 -1 -1 -1 -1 -1 -1 -1 -1 -1 -1 -1 -1 -1 -1 -1 -1 -1 23 
25 -1 -1 -1 -1 -1 -1 -1 -1 -1 -1 -1 -1 -1 -1 -1 -1 -1 -1 23 
25 -1 -1 -1 -1 -1 -1 -1 -1 -1 -1 -1 -1 -1 -1 -1 -1 -1 -1 23 
25 -1 -1 -1 -1 -1 -1 -1 -1 -1 -1 -1 -1 04 07 05 -1 -1 -1 23 
25 -1 -1 -1 -1 -1 -1 -1 -1 -1 -1 -1 -1 23 24 25 -1 -1 -1 23 
25 -1 -1 -1 -1 -1 -1 04 07 05 -1 -1 -1 23 24 25 -1 -1 -1 23 
25 -1 -1 -1 -1 -1 -1 23 24 25 -1 -1 -1 23 24 25 -1 -1 -1 23 
31 07 07 05 -1 -1 -1 23 24 25 -1 -1 -1 23 24 25 -1 -1 -1 23 
24 24 24 25 -1 -1 -1 23 24 25 -1 -1 -1 23 24 25 -1 -1 -1 23 
0
4
2 4 8 0 1 0 2
2 12 10 0 0 0 2
2 9 4 2 0 0 2
2 13 6 2 1 0 2