48 380 2
17 2 0
24 24 24 24 24 24 24 00 00 00 24 24 24 24 24 24 24 24 24 24 
29 27 27 27 27 30 24 00 00 00 24 29 27 27 27 27 27 27 27 30 
25 -1 -1 -1 -1 23 24 24 24 24 24 25 -1 -1 -1 -1 -1 -1 -1 23 
25 -1 -1 -1 -1 23 29 27 27 27 27 28 -1 -1 -1 -1 -1 -1 -1 23 
25 -1 -1 -1 -1 23 25 -1 -1 -1 -1 -1 -1 -1 -1 04 05 -1 -1 23 
31 07 05 -1 -1 13 28 -1 -1 -1 -1 -1 -1 41 04 32 25 -1 -1 23 
24 24 25 -1 -1 -1 -1 -1 -1 04 07 07 07 07 32 00 25 -1 -1 23 
00 24 25 -1 -1 -1 -1 -1 -1 23 29 27 27 27 27 27 28 -1 -1 23 
00 24 25 -1 -1 -1 -1 -1 -1 23 25 -1 -1 -1 -1 -1 -1 -1 -1 23 
00 24 25 -1 -1 -1 -1 -1 -1 23 25 -1 -1 -1 -1 -1 -1 -1 -1 23 
00 24 25 -1 -1 -1 -1 -1 -1 23 25 -1 -1 -1 04 07 07 07 07 32 
00 24 25 -1 -1 -1 -1 -1 -1 23 25 -1 -1 -1 13 27 27 36 27 30 
00 24 25 -1 -1 -1 -1 -1 -1 23 25 -1 -1 -1 -1 -1 -1 -1 41 23 
00 24 25 -1 -1 -1 -1 -1 -1 23 25 -1 -1 -1 -1 -1 -1 -1 41 23 
00 24 25 42 42 42 42 42 42 23 31 07 07 07 07 07 07 07 07 32 
2
6 2 1
12 5 1
5
0 4 4 0 4 5
0 5 5 0 3 5
0 6 6 0 2 5
3 14 10 0 0 60
3 16 1 0 0 60