48 120 2
8 12 3
25 40 40 40 40 40 23 29 27 27 27 27 27 27 27 27 27 27 27 30 
25 -1 -1 -1 -1 -1 23 25 -1 -1 -1 -1 -1 -1 -1 -1 -1 -1 -1 13 
25 -1 -1 -1 -1 -1 23 39 -1 -1 -1 -1 -1 -1 -1 -1 -1 -1 -1 41 
25 -1 -1 -1 -1 -1 23 31 07 07 07 07 07 07 07 05 -1 -1 -1 41 
25 -1 -1 -1 -1 -1 13 27 27 27 27 27 27 27 27 15 -1 -1 -1 41 
25 -1 -1 -1 -1 -1 40 40 40 40 40 40 40 40 40 40 -1 -1 -1 41 
25 -1 -1 02 06 03 -1 -1 -1 -1 -1 -1 -1 -1 -1 -1 -1 -1 -1 04 
25 -1 -1 -1 -1 -1 -1 -1 -1 -1 -1 -1 -1 -1 -1 -1 -1 -1 -1 13 
25 -1 -1 -1 -1 -1 -1 -1 -1 -1 -1 02 06 05 -1 -1 -1 -1 -1 41 
25 -1 -1 -1 -1 -1 -1 -1 -1 -1 -1 -1 -1 35 -1 -1 -1 -1 -1 41 
25 -1 -1 04 05 -1 -1 -1 -1 -1 -1 -1 -1 -1 -1 -1 -1 -1 -1 41 
25 -1 -1 23 25 -1 -1 -1 -1 -1 -1 -1 -1 -1 -1 -1 -1 -1 -1 41 
31 07 07 32 25 -1 -1 -1 -1 -1 -1 -1 -1 -1 -1 -1 -1 -1 -1 04 
24 24 24 24 25 -1 -1 -1 02 03 -1 -1 -1 -1 -1 -1 -1 -1 -1 23 
00 00 00 24 25 42 42 42 42 42 42 42 42 42 42 42 42 42 42 23 
1
14 1 1
2
4 8 7 0 59
4 18 4 40 59