48 90 2
18 2 2
25 -1 -1 13 27 27 30 25 -1 -1 -1 -1 23 29 27 27 28 -1 -1 23 
25 -1 -1 -1 -1 -1 13 28 -1 -1 -1 -1 13 28 -1 -1 -1 -1 -1 23 
25 -1 -1 -1 -1 -1 -1 -1 -1 -1 -1 -1 -1 -1 -1 -1 -1 -1 -1 23 
25 -1 -1 -1 -1 -1 -1 -1 -1 -1 -1 -1 -1 -1 -1 -1 -1 -1 -1 23 
25 -1 -1 -1 -1 -1 -1 -1 -1 17 19 -1 -1 -1 -1 -1 -1 -1 -1 23 
25 -1 -1 04 05 -1 -1 -1 -1 -1 -1 -1 -1 -1 -1 04 05 -1 -1 23 
25 -1 -1 23 25 -1 -1 -1 -1 -1 -1 -1 -1 -1 -1 23 25 -1 -1 23 
25 -1 -1 23 31 07 05 -1 -1 -1 -1 -1 -1 04 07 32 25 -1 -1 23 
25 -1 -1 13 30 24 25 -1 -1 -1 -1 -1 -1 23 24 29 28 -1 -1 23 
25 -1 -1 -1 13 30 31 05 42 42 42 42 04 32 29 28 -1 -1 -1 23 
25 -1 -1 -1 -1 23 24 31 21 21 21 21 32 24 25 -1 -1 -1 -1 23 
25 -1 -1 -1 -1 13 27 27 27 27 27 27 27 27 28 -1 -1 -1 -1 23 
25 -1 -1 -1 -1 -1 -1 -1 -1 -1 -1 -1 -1 -1 -1 -1 -1 -1 -1 23 
31 07 05 -1 -1 -1 -1 -1 -1 -1 -1 -1 -1 -1 -1 -1 -1 04 38 32 
00 00 25 -1 -1 -1 -1 -1 -1 -1 -1 -1 -1 -1 -1 -1 -1 23 00 00 
0
4
0 1 5 1 0 2
0 18 5 0 0 2
5 7 12 0 59
5 12 12 40 59