304 90 2
10 12 0
-1 -1 -1 -1 -1 -1 -1 -1 23 00 00 25 -1 -1 -1 -1 -1 -1 -1 -1 
-1 -1 02 03 -1 -1 16 -1 13 27 36 28 -1 16 -1 -1 02 03 -1 -1 
-1 -1 -1 -1 -1 -1 -1 -1 -1 -1 -1 -1 -1 -1 -1 -1 -1 -1 -1 -1 
-1 -1 -1 -1 -1 -1 -1 -1 -1 -1 -1 -1 -1 -1 -1 -1 -1 -1 -1 -1 
-1 -1 -1 -1 -1 -1 -1 -1 -1 -1 -1 -1 -1 -1 -1 -1 -1 -1 -1 -1 
-1 -1 -1 -1 -1 02 06 06 06 06 06 06 06 06 03 -1 -1 -1 -1 -1 
-1 -1 -1 -1 -1 40 40 40 40 -1 -1 40 40 40 40 -1 -1 -1 -1 -1 
-1 -1 -1 -1 -1 -1 -1 -1 -1 -1 -1 -1 -1 -1 -1 -1 -1 -1 -1 -1 
-1 -1 -1 -1 -1 -1 -1 -1 -1 -1 -1 -1 -1 -1 -1 -1 -1 -1 -1 -1 
-1 -1 -1 -1 -1 33 -1 42 42 42 42 42 42 -1 33 -1 -1 -1 -1 -1 
-1 -1 -1 -1 -1 34 -1 17 09 09 09 09 19 -1 34 -1 -1 -1 -1 -1 
-1 33 -1 -1 -1 35 -1 -1 -1 -1 -1 -1 -1 -1 35 -1 -1 -1 33 -1 
-1 35 -1 -1 -1 -1 -1 -1 -1 -1 -1 -1 -1 -1 -1 -1 -1 -1 35 -1 
-1 -1 -1 -1 -1 -1 -1 -1 -1 04 05 -1 -1 -1 -1 -1 -1 -1 -1 -1 
-1 -1 -1 -1 -1 -1 -1 -1 -1 23 25 -1 -1 -1 -1 -1 -1 -1 -1 -1 
4
6 2 0
13 2 1
1 6 0
18 6 1
6
1 6 12 0 0 2
1 13 10 1 0 2
4 1 11 0 59
4 18 11 40 59
5 4 7 40 59
5 15 7 0 59