208 90 2
17 1 1
25 -1 -1 23 24 25 -1 -1 -1 -1 -1 -1 -1 -1 -1 -1 -1 -1 -1 -1 
25 -1 -1 23 24 25 -1 -1 -1 -1 -1 -1 -1 -1 -1 -1 -1 -1 -1 -1 
25 -1 -1 23 24 25 -1 -1 -1 -1 -1 -1 -1 -1 -1 -1 -1 -1 16 -1 
25 -1 -1 23 24 25 -1 -1 -1 -1 -1 -1 -1 -1 -1 -1 -1 -1 -1 -1 
25 -1 -1 13 30 25 -1 -1 04 07 07 07 05 -1 -1 -1 -1 -1 -1 -1 
25 -1 -1 -1 13 28 -1 -1 13 27 30 29 28 -1 -1 -1 -1 -1 -1 -1 
25 -1 -1 -1 -1 -1 -1 -1 -1 -1 23 25 43 -1 -1 -1 -1 -1 16 -1 
25 -1 -1 -1 -1 -1 -1 -1 -1 04 32 25 43 -1 -1 -1 -1 -1 -1 -1 
25 -1 -1 04 07 07 07 07 07 32 24 31 22 -1 -1 -1 -1 -1 -1 -1 
25 -1 -1 13 27 27 27 27 30 24 24 29 28 -1 -1 -1 -1 -1 -1 -1 
25 -1 -1 -1 -1 -1 -1 -1 23 24 24 25 43 -1 -1 04 07 07 07 07 
25 -1 -1 -1 -1 -1 -1 -1 23 24 24 25 43 -1 -1 13 27 27 30 24 
25 -1 -1 -1 -1 -1 -1 -1 23 24 24 25 43 -1 -1 -1 -1 -1 23 24 
25 42 42 04 07 07 07 07 32 24 24 25 43 -1 -1 -1 -1 -1 37 24 
31 21 21 32 24 24 24 24 24 24 24 25 43 -1 -1 -1 -1 04 32 24 
1
8 13 0
2
3 9 8 0 0 63
3 8 7 0 28 63