112 112 2
3 11 3
-1 23 24 24 24 24 24 25 -1 -1 -1 -1 -1 42 -1 -1 -1 -1 -1 -1 
-1 23 29 27 27 27 27 28 -1 -1 -1 -1 -1 16 -1 -1 -1 -1 -1 -1 
-1 23 25 40 40 40 40 40 -1 -1 -1 -1 -1 40 -1 -1 -1 -1 -1 -1 
-1 23 39 -1 -1 -1 -1 -1 -1 -1 42 -1 -1 -1 -1 -1 -1 -1 -1 -1 
-1 23 25 42 42 42 42 42 -1 -1 16 -1 -1 -1 -1 -1 -1 -1 -1 -1 
-1 23 31 21 21 21 21 22 -1 -1 40 -1 -1 -1 -1 -1 -1 -1 -1 -1 
-1 13 27 27 27 27 27 28 -1 -1 04 07 07 07 07 05 -1 -1 -1 -1 
-1 -1 -1 -1 -1 -1 -1 -1 -1 -1 23 24 24 24 24 25 -1 -1 -1 -1 
-1 -1 -1 -1 -1 -1 -1 -1 -1 -1 23 24 24 24 24 25 -1 -1 -1 -1 
-1 04 05 -1 -1 04 05 -1 -1 -1 13 27 27 27 27 28 -1 -1 -1 -1 
-1 23 25 -1 -1 23 25 -1 -1 -1 -1 -1 -1 -1 -1 -1 -1 -1 -1 -1 
-1 23 25 -1 -1 23 25 -1 -1 -1 -1 -1 -1 -1 -1 -1 -1 -1 -1 -1 
-1 23 31 07 07 32 25 -1 -1 -1 04 07 07 07 07 05 -1 -1 -1 -1 
-1 13 27 27 27 27 28 -1 -1 -1 13 27 27 27 27 28 -1 -1 -1 -1 
-1 -1 -1 -1 -1 -1 -1 -1 -1 -1 -1 -1 -1 -1 -1 -1 -1 -1 -1 -1 
1
17 12 1
3
6 3 5 3 0 18
6 11 4 0 17 18
6 14 3 2 0 18