48 400 2
18 4 1
29 27 27 27 27 30 25 -1 -1 -1 -1 -1 -1 -1 -1 -1 -1 -1 -1 -1 
25 -1 -1 -1 -1 23 25 -1 -1 02 06 03 -1 -1 -1 -1 -1 -1 -1 -1 
25 -1 -1 -1 -1 23 25 -1 -1 -1 -1 -1 -1 -1 -1 -1 -1 -1 -1 -1 
31 07 05 -1 -1 23 25 -1 -1 -1 -1 -1 -1 -1 -1 -1 -1 -1 -1 04 
29 27 28 -1 -1 23 25 -1 -1 -1 -1 -1 -1 -1 -1 -1 42 -1 -1 13 
25 -1 -1 -1 -1 23 25 -1 -1 -1 -1 -1 -1 -1 -1 -1 16 -1 -1 -1 
25 -1 -1 -1 -1 23 25 -1 -1 -1 -1 -1 -1 -1 -1 -1 40 -1 -1 04 
25 -1 -1 04 07 32 25 -1 -1 -1 -1 -1 -1 -1 -1 -1 42 -1 -1 13 
25 -1 -1 13 27 27 28 -1 -1 -1 -1 -1 -1 -1 -1 -1 16 -1 -1 -1 
25 -1 -1 -1 -1 -1 -1 -1 -1 -1 -1 -1 -1 -1 -1 -1 40 -1 -1 04 
25 -1 -1 -1 -1 -1 -1 -1 -1 -1 -1 -1 -1 -1 -1 -1 -1 -1 -1 37 
31 07 07 07 07 07 05 -1 -1 -1 -1 02 06 03 -1 -1 -1 -1 -1 13 
24 24 24 24 24 24 25 -1 -1 -1 -1 -1 -1 -1 -1 -1 -1 -1 -1 -1 
00 00 00 00 00 24 25 -1 -1 -1 -1 -1 -1 -1 -1 -1 -1 -1 -1 -1 
00 00 00 00 00 24 25 -1 -1 -1 -1 -1 -1 -1 -1 -1 -1 -1 -1 -1 
1
14 12 0
4
6 3 10 3 0 18
6 2 7 1 17 18
2 9 12 0 1 0 2
2 13 4 2 0 0 2