48 48 2
18 13 1
-1 -1 -1 -1 -1 -1 -1 -1 -1 -1 -1 -1 -1 -1 -1 -1 -1 13 27 30 
-1 -1 -1 -1 -1 -1 -1 -1 -1 -1 -1 -1 -1 -1 -1 -1 -1 -1 -1 37 
-1 -1 04 05 -1 -1 33 43 -1 -1 -1 -1 42 42 42 -1 -1 -1 -1 13 
-1 -1 23 25 -1 -1 34 43 -1 -1 -1 41 08 21 10 43 -1 -1 -1 -1 
-1 -1 13 28 -1 -1 35 43 -1 -1 -1 41 23 24 25 43 -1 -1 -1 -1 
-1 -1 -1 -1 -1 -1 -1 -1 -1 -1 -1 41 13 27 28 43 -1 -1 -1 -1 
-1 -1 -1 -1 -1 -1 -1 -1 -1 -1 -1 -1 40 40 40 -1 -1 -1 -1 -1 
-1 -1 -1 -1 -1 -1 -1 -1 -1 -1 -1 -1 -1 -1 -1 -1 -1 -1 -1 -1 
-1 -1 -1 -1 -1 -1 -1 -1 -1 -1 -1 -1 -1 -1 -1 -1 -1 -1 -1 -1 
-1 -1 -1 -1 -1 -1 -1 -1 -1 -1 -1 -1 -1 -1 -1 -1 -1 -1 -1 -1 
-1 -1 -1 -1 -1 -1 -1 -1 -1 -1 -1 -1 41 33 -1 -1 04 05 -1 -1 
-1 -1 -1 -1 -1 -1 -1 -1 -1 -1 -1 -1 41 34 -1 -1 23 25 -1 -1 
05 -1 -1 -1 -1 -1 -1 -1 -1 -1 -1 -1 41 35 -1 -1 13 28 -1 -1 
25 -1 -1 -1 -1 -1 -1 -1 -1 -1 -1 -1 -1 -1 -1 -1 -1 -1 -1 -1 
31 07 05 -1 -1 -1 -1 -1 -1 -1 -1 -1 -1 -1 -1 -1 -1 -1 -1 -1 
1
7 1 1
2
6 4 11 3 0 20
6 15 3 1 0 20