48 48 2
17 1 2
29 27 27 27 30 24 24 25 -1 -1 -1 -1 23 24 24 29 27 27 27 30 
25 -1 -1 -1 23 24 24 25 -1 -1 -1 -1 23 24 24 25 -1 -1 -1 23 
25 -1 -1 -1 23 24 24 25 -1 -1 -1 -1 23 24 24 25 -1 -1 -1 23 
25 -1 -1 -1 23 24 29 28 -1 -1 -1 -1 13 30 24 25 -1 -1 -1 23 
25 -1 -1 04 32 29 28 -1 -1 -1 -1 -1 -1 13 30 31 05 -1 -1 23 
25 -1 -1 13 27 28 -1 -1 -1 -1 -1 -1 -1 -1 13 27 28 -1 -1 23 
25 -1 -1 -1 -1 -1 -1 -1 -1 42 42 -1 -1 -1 -1 -1 -1 -1 -1 23 
25 -1 -1 -1 -1 -1 -1 -1 -1 08 22 -1 -1 -1 -1 -1 -1 -1 -1 23 
25 -1 -1 -1 -1 -1 -1 -1 -1 13 28 -1 -1 -1 -1 -1 -1 -1 -1 23 
25 -1 -1 -1 -1 -1 -1 -1 -1 40 40 -1 -1 -1 -1 -1 -1 -1 -1 23 
31 05 -1 -1 04 05 -1 -1 -1 -1 -1 -1 -1 -1 04 05 43 -1 41 23 
29 28 -1 -1 23 31 05 -1 -1 -1 -1 -1 -1 04 32 25 43 -1 41 23 
25 -1 -1 -1 23 24 31 05 -1 -1 -1 -1 04 32 24 25 43 -1 41 23 
25 -1 -1 -1 23 24 24 25 -1 -1 -1 -1 23 24 24 25 43 -1 41 23 
31 07 07 07 32 24 24 25 -1 -1 -1 -1 23 24 24 31 07 38 07 32 
2
2 12 0
17 12 0
0