48 432 2
18 13 1
25 -1 -1 -1 -1 -1 -1 -1 -1 -1 -1 -1 -1 -1 -1 -1 -1 -1 -1 23 
25 -1 -1 -1 -1 -1 -1 -1 -1 -1 -1 -1 -1 -1 -1 -1 -1 -1 -1 37 
31 07 05 -1 -1 -1 04 07 05 -1 -1 04 07 07 05 -1 -1 -1 -1 23 
24 24 25 -1 -1 -1 23 24 25 -1 -1 13 30 00 25 -1 -1 -1 -1 23 
00 24 25 -1 -1 -1 23 29 28 -1 -1 -1 23 00 31 07 07 07 07 32 
00 24 25 -1 -1 -1 23 25 -1 -1 -1 04 32 00 29 27 27 27 27 27 
00 24 25 -1 -1 -1 23 31 05 -1 -1 13 27 27 28 40 40 40 40 40 
00 24 25 -1 -1 -1 13 27 28 -1 -1 -1 -1 -1 -1 -1 -1 -1 -1 -1 
00 24 25 -1 -1 -1 -1 -1 -1 -1 -1 -1 -1 -1 -1 -1 -1 -1 -1 -1 
00 24 25 -1 -1 -1 -1 -1 -1 -1 -1 42 -1 -1 -1 42 -1 -1 42 -1 
00 24 25 -1 -1 -1 -1 -1 -1 -1 41 16 43 -1 41 16 -1 41 16 43 
00 24 25 -1 -1 -1 -1 -1 -1 -1 -1 -1 -1 -1 -1 40 -1 -1 40 -1 
00 24 25 -1 -1 -1 -1 -1 -1 -1 -1 42 -1 -1 -1 -1 -1 -1 -1 -1 
00 24 25 -1 -1 -1 -1 -1 -1 -1 41 16 43 -1 -1 -1 -1 -1 -1 -1 
00 24 25 -1 -1 -1 -1 -1 -1 -1 -1 40 -1 -1 -1 -1 -1 -1 -1 -1 
3
4 1 1
17 1 1
16 7 1
2
3 8 9 1 0 41
3 11 10 0 25 41