-1 -1 25 -1 -1 23 24 25 -1 -1 -1 -1 23 24 25 -1 -1 -1 -1 -1 
00 24 25 -1 -1 13 27 28 -1 -1 -1 -1 13 27 28 -1 16 -1 -1 -1 
00 24 25 -1 -1 -1 -1 -1 -1 -1 -1 -1 -1 -1 -1 -1 -1 -1 -1 -1 
24 24 25 -1 -1 -1 -1 -1 -1 -1 -1 -1 -1 -1 -1 -1 -1 -1 -1 -1 
29 27 28 -1 -1 -1 -1 -1 -1 -1 -1 -1 -1 -1 -1 -1 -1 -1 -1 -1 
25 -1 -1 -1 -1 33 -1 -1 -1 -1 -1 -1 -1 -1 33 -1 -1 04 38 07 
25 -1 -1 -1 -1 -1 -1 -1 -1 -1 -1 -1 -1 -1 -1 -1 -1 23 24 24 
25 -1 -1 -1 -1 35 -1 -1 -1 -1 -1 -1 -1 -1 35 -1 -1 23 24 24 
25 -1 -1 -1 -1 -1 -1 -1 -1 -1 -1 -1 -1 -1 -1 -1 -1 13 27 27 
31 07 05 -1 -1 -1 -1 -1 17 09 09 19 -1 -1 -1 -1 -1 -1 -1 -1 
24 24 25 -1 -1 -1 -1 -1 -1 -1 -1 -1 -1 -1 -1 -1 -1 -1 -1 -1 
00 24 25 -1 -1 -1 -1 -1 -1 -1 -1 -1 -1 -1 -1 -1 -1 -1 -1 -1 
00 24 25 -1 -1 -1 -1 -1 -1 -1 -1 -1 -1 -1 -1 -1 -1 -1 -1 -1 
00 24 25 -1 -1 -1 -1 -1 04 07 07 05 -1 -1 -1 -1 -1 -1 -1 -1 
00 24 25 -1 -1 -1 -1 -1 23 24 24 25 -1 -1 -1 -1 -1 -1 -1 -1 
