48 208 2
18 10 2
00 24 25 -1 -1 23 24 25 -1 -1 -1 -1 23 24 25 -1 -1 -1 -1 -1 
00 24 25 -1 -1 13 27 28 -1 -1 -1 -1 13 27 28 -1 16 -1 -1 -1 
00 24 25 -1 -1 -1 -1 -1 -1 -1 -1 -1 -1 -1 -1 -1 -1 -1 -1 -1 
24 24 25 -1 -1 -1 -1 -1 -1 -1 -1 -1 -1 -1 -1 -1 -1 -1 -1 -1 
29 27 28 -1 -1 -1 -1 -1 -1 -1 -1 -1 -1 -1 -1 -1 -1 -1 -1 -1 
25 -1 -1 -1 -1 33 -1 -1 -1 -1 -1 -1 -1 -1 33 -1 -1 04 38 07 
25 -1 -1 -1 -1 34 -1 -1 -1 -1 -1 -1 -1 -1 34 -1 -1 23 24 24 
25 -1 -1 -1 -1 35 -1 -1 -1 -1 -1 -1 -1 -1 35 -1 -1 23 24 24 
25 -1 -1 -1 -1 -1 -1 -1 42 42 42 42 -1 -1 -1 -1 -1 13 27 27 
31 07 05 -1 -1 -1 -1 -1 17 09 09 19 -1 -1 -1 -1 -1 -1 -1 -1 
24 24 25 -1 -1 -1 -1 -1 -1 -1 -1 -1 -1 -1 -1 -1 -1 -1 -1 -1 
00 24 25 -1 -1 -1 -1 -1 -1 -1 -1 -1 -1 -1 -1 -1 -1 -1 -1 -1 
00 24 25 -1 -1 -1 -1 -1 -1 -1 -1 -1 -1 -1 -1 -1 -1 -1 -1 -1 
00 24 25 -1 -1 -1 -1 -1 04 07 07 05 -1 -1 -1 -1 -1 -1 -1 -1 
00 24 25 -1 -1 -1 -1 -1 23 24 24 25 -1 -1 -1 -1 -1 -1 -1 -1 
0
6
5 8 8 0 59
5 11 8 40 59
4 8 12 0 59
4 11 12 40 59
4 4 3 0 59
4 15 3 40 59