336 432 2
10 2 2
-1 -1 -1 -1 -1 -1 -1 -1 -1 -1 -1 -1 -1 -1 -1 -1 -1 -1 -1 -1 
-1 -1 -1 -1 -1 -1 -1 -1 -1 -1 -1 -1 -1 -1 -1 -1 -1 -1 -1 -1 
-1 -1 -1 -1 -1 02 03 -1 -1 02 03 -1 -1 02 03 -1 -1 -1 -1 -1 
-1 -1 -1 -1 -1 -1 -1 -1 -1 -1 -1 -1 -1 -1 -1 -1 -1 -1 -1 -1 
-1 -1 -1 -1 -1 -1 -1 -1 -1 -1 -1 -1 -1 -1 -1 -1 -1 -1 -1 -1 
-1 -1 -1 -1 -1 42 42 -1 -1 42 42 -1 -1 42 42 -1 -1 -1 -1 -1 
05 -1 -1 08 21 21 21 21 21 21 21 21 21 21 21 21 10 -1 -1 04 
25 -1 -1 13 27 30 29 27 27 27 27 27 27 30 29 27 28 -1 -1 23 
25 -1 -1 -1 -1 23 25 40 40 40 40 40 40 23 25 -1 -1 -1 -1 23 
25 -1 -1 -1 -1 23 25 -1 -1 -1 -1 -1 -1 23 25 -1 -1 -1 -1 23 
31 21 22 -1 -1 23 25 -1 -1 -1 -1 -1 -1 23 25 -1 -1 08 21 32 
27 27 28 -1 -1 13 28 -1 -1 -1 -1 -1 -1 13 28 -1 -1 13 27 27 
-1 -1 -1 -1 -1 -1 -1 -1 -1 -1 -1 -1 -1 -1 -1 -1 -1 -1 -1 -1 
-1 -1 -1 -1 -1 -1 -1 -1 04 07 38 05 -1 -1 -1 -1 -1 -1 -1 -1 
-1 -1 -1 -1 33 -1 -1 -1 23 24 24 25 -1 -1 -1 33 -1 -1 -1 -1 
2
8 4 1
11 4 1
4
3 0 9 1 0 30
3 19 9 0 0 30
6 3 3 3 0 18
6 16 3 1 0 18