-1 -1 -1 -1 -1 -1 -1 -1 -1 -1 -1 -1 -1 -1 -1 -1 -1 -1 -1 -1 
-1 -1 -1 -1 -1 -1 -1 -1 -1 -1 -1 -1 -1 -1 -1 -1 -1 -1 -1 -1 
-1 -1 -1 -1 -1 02 -1 -1 -1 02 -1 -1 -1 02 -1 -1 -1 -1 -1 -1 
-1 -1 -1 -1 -1 -1 -1 -1 -1 -1 -1 -1 -1 -1 -1 -1 -1 -1 -1 -1 
-1 -1 -1 -1 -1 -1 -1 -1 -1 -1 -1 -1 -1 -1 -1 -1 -1 -1 -1 -1 
-1 -1 -1 -1 -1 -1 -1 -1 -1 -1 -1 -1 -1 -1 -1 -1 -1 -1 -1 -1 
05 -1 -1 08 21 21 21 21 21 21 21 21 21 21 21 21 10 -1 -1 04 
25 -1 -1 13 27 30 29 27 27 27 27 27 27 30 29 27 28 -1 -1 23 
25 -1 -1 -1 -1 23 25 -1 -1 -1 -1 -1 -1 23 25 -1 -1 -1 -1 23 
25 -1 -1 -1 -1 23 25 -1 -1 -1 -1 -1 -1 23 25 -1 -1 -1 -1 23 
31 21 22 -1 -1 23 25 -1 -1 -1 -1 -1 -1 23 25 -1 -1 08 21 32 
27 27 28 -1 -1 13 28 -1 -1 -1 -1 -1 -1 13 28 -1 -1 13 27 27 
-1 -1 -1 -1 -1 -1 -1 -1 -1 -1 -1 -1 -1 -1 -1 -1 -1 -1 -1 -1 
-1 -1 -1 -1 -1 -1 -1 -1 04 07 38 05 -1 -1 -1 -1 -1 -1 -1 -1 
-1 -1 -1 -1 33 -1 -1 -1 23 24 24 25 -1 -1 -1 33 -1 -1 -1 -1 
