48 80 2
1 8 2
29 27 27 27 28 -1 -1 -1 23 24 24 24 24 24 25 -1 -1 23 24 00 
25 -1 -1 -1 -1 -1 -1 -1 13 27 27 27 27 27 28 -1 -1 23 24 24 
25 -1 -1 -1 -1 -1 -1 -1 -1 -1 -1 -1 -1 -1 -1 -1 -1 13 27 27 
25 -1 -1 -1 -1 -1 -1 -1 -1 -1 -1 -1 -1 -1 -1 -1 -1 -1 -1 -1 
25 -1 -1 04 07 07 07 07 07 07 07 07 07 07 05 -1 -1 -1 -1 -1 
25 -1 -1 23 24 24 24 29 27 27 27 27 27 30 31 07 05 -1 -1 -1 
25 -1 -1 23 29 27 27 28 -1 -1 -1 -1 -1 13 27 27 28 -1 -1 -1 
31 38 07 32 25 40 40 40 -1 -1 -1 -1 -1 40 40 40 40 -1 -1 -1 
24 24 24 24 25 -1 -1 -1 -1 -1 -1 -1 -1 -1 -1 -1 -1 -1 -1 -1 
24 24 24 24 25 -1 -1 -1 -1 -1 -1 -1 -1 -1 -1 -1 -1 -1 -1 04 
29 27 27 27 28 -1 -1 -1 -1 -1 16 -1 -1 -1 -1 -1 16 -1 -1 23 
25 -1 -1 -1 -1 -1 -1 -1 -1 -1 -1 -1 -1 -1 -1 -1 -1 -1 -1 23 
25 -1 -1 -1 -1 -1 -1 -1 -1 -1 -1 -1 -1 -1 -1 -1 -1 -1 -1 23 
31 07 07 07 07 07 07 07 07 07 07 07 07 07 07 07 07 07 07 32 
24 24 24 24 24 24 24 24 24 24 24 24 24 24 24 24 24 24 24 24 
0
6
5 9 8 0 39
5 11 8 30 39
4 13 5 15 39
3 4 11 1 0 26
6 9 11 2 0 18
6 13 11 2 17 18