-1 27 27 27 28 -1 -1 -1 23 24 24 24 24 24 25 -1 -1 23 -1 -1 
25 -1 -1 -1 -1 -1 -1 -1 13 27 27 27 27 27 28 -1 -1 23 24 24 
25 -1 -1 -1 -1 -1 -1 -1 -1 -1 -1 -1 -1 -1 -1 -1 -1 13 27 27 
25 -1 -1 -1 -1 -1 -1 -1 -1 -1 -1 -1 -1 -1 -1 -1 -1 -1 -1 -1 
25 -1 -1 04 07 07 07 07 07 07 07 07 07 07 05 -1 -1 -1 -1 -1 
25 -1 -1 23 24 24 24 29 27 27 27 27 27 30 31 07 05 -1 -1 -1 
25 -1 -1 23 29 27 27 28 -1 -1 -1 -1 -1 13 27 27 28 -1 -1 -1 
31 38 07 32 25 -1 -1 -1 -1 -1 -1 -1 -1 -1 -1 -1 -1 -1 -1 -1 
24 24 24 24 25 -1 -1 -1 -1 -1 -1 -1 -1 -1 -1 -1 -1 -1 -1 -1 
24 24 24 24 25 -1 -1 -1 -1 -1 -1 -1 -1 -1 -1 -1 -1 -1 -1 04 
29 27 27 27 28 -1 -1 -1 -1 -1 16 -1 -1 -1 -1 -1 16 -1 -1 23 
25 -1 -1 -1 -1 -1 -1 -1 -1 -1 -1 -1 -1 -1 -1 -1 -1 -1 -1 23 
25 -1 -1 -1 -1 -1 -1 -1 -1 -1 -1 -1 -1 -1 -1 -1 -1 -1 -1 23 
31 07 07 07 07 07 07 07 07 07 07 07 07 07 07 07 07 07 07 32 
24 24 24 24 24 24 24 24 24 24 24 24 24 24 24 24 24 24 24 24 
