48 400 2
12 1 2
29 27 27 27 30 24 25 -1 -1 -1 -1 -1 23 24 00 00 00 00 00 00 
25 -1 -1 -1 23 24 25 -1 -1 -1 -1 -1 23 24 00 00 00 00 00 00 
25 -1 -1 -1 23 24 25 -1 -1 -1 -1 -1 23 24 00 00 00 00 00 00 
31 05 -1 -1 23 24 25 -1 -1 -1 -1 -1 23 24 00 00 00 00 00 00 
29 28 -1 -1 13 30 25 -1 -1 -1 -1 -1 23 24 24 24 24 24 24 24 
25 -1 -1 -1 -1 23 25 -1 -1 -1 -1 -1 13 27 27 27 27 27 27 30 
25 -1 -1 -1 -1 23 25 -1 -1 -1 -1 -1 -1 -1 -1 -1 -1 -1 -1 23 
31 05 -1 -1 04 32 25 -1 -1 -1 -1 -1 -1 -1 -1 -1 -1 -1 -1 23 
27 28 -1 -1 23 24 25 -1 -1 -1 -1 -1 04 07 07 07 05 -1 -1 23 
-1 -1 -1 -1 13 27 28 -1 -1 -1 -1 -1 23 24 24 24 25 -1 -1 23 
-1 -1 -1 -1 -1 -1 -1 -1 -1 04 07 07 32 24 24 24 25 -1 -1 23 
-1 -1 -1 -1 -1 -1 -1 -1 -1 23 24 29 27 27 27 27 28 -1 -1 23 
-1 -1 -1 -1 -1 -1 04 07 07 32 24 25 -1 -1 -1 -1 -1 -1 -1 23 
-1 -1 -1 -1 -1 -1 23 24 24 24 24 25 -1 -1 -1 -1 -1 -1 -1 23 
-1 -1 -1 -1 -1 -1 23 24 00 00 24 31 38 07 07 07 07 07 07 32 
0
0