48 368 2
18 11 2
29 27 27 27 27 27 27 27 27 30 29 27 27 27 27 27 27 27 27 30 
25 -1 -1 -1 -1 -1 -1 -1 -1 23 25 -1 -1 -1 -1 -1 -1 -1 -1 23 
25 -1 -1 -1 -1 -1 -1 -1 -1 23 25 -1 -1 -1 -1 -1 -1 -1 -1 23 
25 -1 -1 04 05 -1 -1 -1 -1 23 25 -1 -1 -1 -1 04 05 -1 -1 23 
31 07 07 32 25 -1 -1 04 07 32 31 07 05 -1 -1 23 31 07 38 32 
24 24 24 24 25 -1 -1 23 24 24 24 24 25 -1 -1 23 24 24 24 24 
00 00 24 29 28 -1 -1 23 29 27 27 30 25 -1 -1 13 30 24 00 00 
00 00 24 25 -1 -1 -1 23 25 -1 -1 23 25 -1 -1 -1 23 24 00 00 
00 00 24 25 -1 -1 -1 23 25 -1 -1 23 25 -1 -1 -1 23 24 00 00 
24 24 24 25 -1 -1 04 32 25 -1 -1 23 31 05 -1 -1 23 24 24 24 
29 27 27 28 -1 -1 13 27 28 -1 -1 13 27 28 -1 -1 13 27 27 30 
25 -1 -1 -1 -1 -1 -1 -1 -1 -1 -1 -1 -1 -1 -1 -1 -1 -1 -1 23 
25 -1 -1 -1 -1 -1 -1 -1 -1 -1 -1 -1 -1 -1 -1 -1 -1 -1 -1 23 
25 -1 -1 -1 -1 04 05 -1 -1 -1 -1 -1 -1 04 05 -1 -1 -1 -1 23 
31 07 07 07 07 32 25 -1 -1 -1 -1 -1 -1 23 31 07 07 07 07 32 
0
0