48 368 2
18 11 2
29 27 27 27 27 27 27 27 27 30 29 27 27 27 27 27 27 27 27 30 
25 -1 -1 -1 -1 -1 -1 -1 -1 23 25 -1 -1 -1 -1 -1 -1 -1 -1 23 
25 -1 -1 -1 -1 -1 -1 -1 -1 23 25 -1 -1 -1 -1 -1 -1 -1 -1 23 
25 -1 -1 04 05 -1 -1 -1 -1 23 25 -1 -1 -1 -1 04 05 -1 -1 23 
31 07 07 32 25 -1 -1 04 07 32 31 07 05 -1 -1 23 31 07 38 32 
24 24 24 24 25 -1 -1 23 24 24 24 24 25 -1 -1 23 24 24 24 24 
00 00 24 29 28 -1 -1 23 29 27 27 30 25 -1 -1 13 30 24 00 00 
00 00 24 25 -1 -1 -1 23 25 40 40 23 25 -1 -1 -1 23 24 00 00 
00 00 24 25 -1 -1 -1 23 25 -1 -1 23 25 -1 -1 -1 23 24 00 00 
24 24 24 25 -1 -1 04 32 25 -1 -1 23 31 05 -1 -1 23 24 24 24 
29 27 27 28 -1 -1 13 27 28 -1 -1 13 27 28 -1 -1 13 27 27 30 
25 43 -1 -1 -1 -1 -1 -1 -1 -1 -1 -1 -1 -1 -1 -1 -1 -1 41 23 
25 43 -1 -1 -1 -1 -1 -1 -1 -1 -1 -1 -1 -1 -1 -1 -1 -1 41 23 
25 43 -1 -1 -1 04 05 -1 -1 -1 -1 -1 -1 04 05 -1 -1 -1 41 23 
31 07 07 07 07 32 25 -1 -1 -1 -1 -1 -1 23 31 07 07 07 07 32 
2
2 2 1
17 2 0
6
3 8 11 0 0 21
3 11 11 1 0 21
6 6 9 1 0 18
6 13 9 3 0 18
6 5 5 1 0 18
6 14 5 3 0 18