-1 -1 -1 -1 23 25 -1 -1 -1 -1 -1 -1 -1 -1 23 29 27 36 -1 -1 
-1 -1 -1 -1 13 28 -1 -1 -1 -1 -1 -1 -1 -1 13 28 -1 -1 -1 23 
-1 -1 -1 -1 -1 -1 -1 -1 -1 -1 -1 -1 -1 -1 -1 -1 -1 -1 -1 23 
-1 -1 -1 -1 -1 -1 -1 -1 -1 -1 -1 -1 -1 -1 -1 -1 -1 -1 -1 23 
07 05 -1 -1 04 05 -1 -1 -1 -1 -1 -1 -1 -1 04 05 -1 -1 04 32 
27 28 -1 -1 13 28 -1 -1 -1 -1 -1 -1 -1 -1 13 28 -1 -1 13 27 
-1 -1 -1 -1 -1 -1 -1 -1 -1 -1 -1 -1 -1 -1 -1 -1 -1 -1 -1 -1 
-1 -1 -1 -1 -1 -1 -1 -1 -1 -1 -1 -1 -1 -1 -1 -1 -1 -1 -1 -1 
-1 -1 -1 -1 -1 -1 -1 -1 -1 -1 -1 -1 -1 -1 -1 -1 -1 -1 -1 -1 
07 05 -1 -1 04 05 -1 -1 -1 -1 -1 -1 -1 -1 04 05 -1 -1 04 07 
29 28 -1 -1 13 28 -1 -1 -1 -1 -1 -1 -1 -1 13 28 -1 -1 13 27 
25 -1 -1 -1 -1 -1 -1 -1 -1 -1 -1 -1 -1 -1 -1 -1 -1 -1 -1 -1 
25 -1 -1 -1 -1 -1 -1 -1 -1 -1 -1 -1 -1 -1 -1 -1 -1 -1 -1 -1 
25 -1 -1 -1 04 05 -1 -1 -1 -1 -1 -1 -1 -1 04 05 -1 -1 -1 -1 
31 07 07 07 32 25 -1 -1 -1 -1 -1 -1 -1 -1 23 25 -1 -1 -1 -1 
